M_2IPM	CC(C)[C@@](O)(CC(=O)[O-])C(=O)[O-]
M_2PGA	O=C([O-])[C@@H](CO)OP(=O)([O-])[O-]
M_3IPM	CC(C)[C@H](C(=O)[O-])[C@@H](O)C(=O)[O-]
M_4MOP	CC(C)CC(=O)C(=O)[O-]
M_6PG	O=C([O-])[C@H](O)[C@@H](O)[C@H](O)[C@H](O)COP(=O)([O-])[O-]
M_AC	CC(=O)[O-]
M_ACD	CC=O
M_A_DASH_CoA	CC(=O)SCCNC(=O)CCNC(=O)[C@H](O)C(C)(C)COP(=O)([O-])OP(=O)([O-])OC[C@H]1O[C@@H](n2cnc3c(N)ncnc32)[C@H](O)[C@@H]1OP(=O)([O-])[O-]
M_A_DASH_DHL	CC(=O)SC(CCS)CCCCC(N)=O
M_A_DASH_Glu_DASH_SeA	CC(=O)N[C@@H](CCC=O)C(=O)[O-]
M_A_DASH_Ser	CC(=O)OC[C@H]([NH3+])C(=O)[O-]
M_ADN	Nc1ncnc2c1ncn2[C@@H]1O[C@H](CO)[C@@H](O)[C@H]1O
M_ADP	Nc1ncnc2c1ncn2[C@@H]1O[C@H](COP(=O)([O-])OP(=O)([O-])O)[C@@H](O)[C@H]1O
M_ADPG	Nc1ncnc2c1ncn2[C@@H]1O[C@H](COP(=O)([O-])OP(=O)([O-])O[C@H]2O[C@H](CO)[C@@H](O)[C@H](O)[C@H]2O)[C@@H](O)[C@H]1O
M_AGN	[NH3+][C@@H](CC1(C(=O)[O-])C=CC(O)C=C1)C(=O)[O-]
M_AHB	CC[C@](O)(C(C)=O)C(=O)[O-]
M_aH_DASH_Cys	Nc1ncnc2c1ncn2[C@@H]1O[C@H](CSCC[C@H]([NH3+])C(=O)[O-])[C@@H](O)[C@H]1O
M_AL	CC(=O)C(C)(O)C(=O)[O-]
M_Ala	C[C@H]([NH3+])C(=O)[O-]
M_AMP	Nc1ncnc2c1ncn2[C@@H]1O[C@H](COP(=O)([O-])[O-])[C@@H](O)[C@H]1O
M_ANT	Nc1ccccc1C(=O)[O-]
M_APS	Nc1ncnc2c1ncn2[C@@H]1O[C@H](COP(=O)([O-])OS(=O)(=O)[O-])[C@@H](O)[C@H]1O
M_Arg	NC(=[NH2+])NCCC[C@H]([NH3+])C(=O)[O-]
M_Arg_DASH_SCA	[NH2+]=C(NCCC[C@H]([NH3+])C(=O)[O-])NC(CC(=O)[O-])C(=O)[O-]
M_Asn	NC(=O)C[C@H]([NH3+])C(=O)[O-]
M_Asp	[NH3+][C@H](CC(=O)[O-])C(=O)[O-]
M_Asp_DASH_SeA	[NH3+][C@@H](CC=O)C(=O)[O-]
M_AspP	[NH3+][C@@H](CC(=O)OP(=O)([O-])[O-])C(=O)[O-]
M_cACN	O=C([O-])/C=C(/CC(=O)[O-])C(=O)[O-]
M_CAIR	Nc1c(C(=O)[O-])[nH+]cn1[C@@H]1O[C@H](COP(=O)([O-])[O-])[C@@H](O)[C@H]1O
M_CB_DASH_Asp	NC(=O)N[C@@H](CC(=O)[O-])C(=O)[O-]
M_CDP	Nc1ccn([C@@H]2O[C@H](COP(=O)([O-])OP(=O)([O-])O)[C@@H](O)[C@H]2O)c(=O)n1
M_cellulose1	OC[C@H]1O[C@@H](O)[C@H](O)[C@@H](O)[C@@H]1O
M_cellulose2	OC[C@H]1O[C@@H](O[C@@H]2[C@@H](CO)O[C@@H](O)[C@H](O)[C@H]2O)[C@H](O)[C@@H](O)[C@@H]1O
M_cellulose3	OC[C@H]1O[C@@H](O[C@@H]2[C@@H](CO)O[C@@H](O[C@@H]3[C@@H](CO)OC(O)[C@H](O)[C@H]3O)[C@H](O)[C@H]2O)[C@H](O)[C@@H](O)[C@@H]1O
M_CHR	C=C(O[C@@H]1C=C(C(=O)[O-])C=C[C@H]1O)C(=O)[O-]
M_Cit	O=C([O-])CC(O)(CC(=O)[O-])C(=O)[O-]
M_CO2	O=C=O
M_CoA	CC(C)(COP(=O)([O-])OP(=O)([O-])OC[C@H]1O[C@@H](n2cnc3c(N)ncnc32)[C@H](O)[C@@H]1OP(=O)([O-])[O-])[C@@H](O)C(=O)NCCC(=O)NCCS
M_CPD_DASH_Ru5P	O=C([O-])c1ccccc1NCC(=O)[C@H](O)[C@H](O)COP(=O)([O-])[O-]
M_CTH	[NH3+][C@H](CSCC[C@@H]([NH3+])C(=O)[O-])C(=O)[O-]
M_CTL	NC(=O)NCCC[C@H]([NH3+])C(=O)[O-]
M_Cys	[NH3+][C@@H](CS)C(=O)[O-]
M_dADP	Nc1ncnc2c1ncn2[C@H]1C[C@H](O)[C@@H](COP(=O)([O-])OP(=O)([O-])O)O1
M_DAHP	O=C([O-])C(=O)C[C@@H](O)[C@H](O)[C@H](O)COP(=O)([O-])[O-]
M_DAP	[NH3+][C@@H](CCC[C@H]([NH3+])C(=O)[O-])C(=O)[O-]
M_dATP	Nc1ncnc2c1ncn2[C@H]1C[C@H](O)[C@@H](COP(=O)([O-])OP(=O)([O-])OP(=O)([O-])O)O1
M_DC_DASH_AMP	O=C([O-])CC(Nc1ncnc2c1ncn2[C@@H]1O[C@H](COP(=O)([O-])[O-])[C@@H](O)[C@H]1O)C(=O)[O-]
M_dCDP	Nc1ccn([C@H]2C[C@H](O)[C@@H](COP(=O)([O-])OP(=O)([O-])O)O2)c(=O)n1
M_dCTP	Nc1ccn([C@H]2C[C@H](O)[C@@H](COP(=O)([O-])OP(=O)([O-])OP(=O)([O-])O)O2)c(=O)n1
M_DHAP	O=C(CO)COP(=O)([O-])[O-]
M_DHD	O=C([O-])C1=N[C@H](C(=O)[O-])CC=C1
M_DHL	NC(=O)CCCC[C@@H](S)CCS
M_DHMB	CC(C)(O)[C@@H](O)C(=O)[O-]
M_DHMP	CC[C@@](C)(O)[C@@H](O)C(=O)[O-]
M_DHO	O=C1C[C@@H](C(=O)[O-])NC(=O)N1
M_DHQ	O=C1C[C@@](O)(C(=O)[O-])C[C@@H](O)[C@@H]1O
M_DHS	O=C([O-])C1=CC(=O)[C@@H](O)[C@H](O)C1
M_DPGA	O=C(OP(=O)([O-])[O-])[C@H](O)COP(=O)([O-])[O-]
M_dTDP	Cc1cn([C@H]2C[C@H](O)[C@@H](COP(=O)([O-])OP(=O)([O-])O)O2)c(=O)[nH]c1=O
M_dTMP	Cc1cn([C@H]2C[C@H](O)[C@@H](COP(=O)([O-])[O-])O2)c(=O)[nH]c1=O
M_dTTP	Cc1cn([C@H]2C[C@H](O)[C@@H](COP(=O)([O-])OP(=O)([O-])OP(=O)([O-])O)O2)c(=O)[nH]c1=O
M_dUDP	O=c1ccn([C@H]2C[C@H](O)[C@@H](COP(=O)([O-])OP(=O)([O-])O)O2)c(=O)[nH]1
M_dUMP	O=c1ccn([C@H]2C[C@H](O)[C@@H](COP(=O)([O-])[O-])O2)c(=O)[nH]1
M_dUTP	O=c1ccn([C@H]2C[C@H](O)[C@@H](COP(=O)([O-])OP(=O)([O-])OP(=O)([O-])O)O2)c(=O)[nH]1
M_E4P	O=C[C@H](O)[C@H](O)COP(=O)([O-])[O-]
M_EIGP	O=P([O-])([O-])OC[C@@H](O)[C@@H](O)c1c[nH]cn1
M_EPSP	C=C(O[C@@H]1CC(C(=O)[O-])=C[C@@H](OP(=O)([O-])[O-])[C@H]1O)C(=O)[O-]
M_F26BP	O=P([O-])([O-])OC[C@H]1O[C@@](CO)(OP(=O)([O-])[O-])[C@@H](O)[C@@H]1O
M_F6P	O=P([O-])([O-])OC[C@H]1OC(O)(CO)[C@@H](O)[C@@H]1O
M_FAICAR	NC(=O)c1ncn([C@@H]2O[C@H](COP(=O)([O-])[O-])[C@@H](O)[C@H]2O)c1NC=O
M_FBP	O=P([O-])([O-])OC[C@H]1OC(O)(COP(=O)([O-])[O-])[C@@H](O)[C@@H]1O
M_FGAR	O=CNCC(=O)N[C@@H]1O[C@H](COP(=O)([O-])[O-])[C@@H](O)[C@H]1O
M_For	O=C[O-]
M_Frc	OC[C@H]1OC(O)(CO)[C@@H](O)[C@@H]1O
M_Fum	O=C([O-])/C=C/C(=O)[O-]
M_G1P	O=P([O-])([O-])O[C@H]1O[C@H](CO)[C@@H](O)[C@H](O)[C@H]1O
M_G6P	O=P([O-])([O-])OC[C@H]1OC(O)[C@H](O)[C@@H](O)[C@@H]1O
M_GABA	[NH3+]CCCC(=O)[O-]
M_GAP	O=C[C@H](O)COP(=O)([O-])[O-]
M_GAR	[NH3+]CC(=O)N[C@@H]1O[C@H](COP(=O)([O-])[O-])[C@@H](O)[C@H]1O
M_GCA	O=C([O-])CO
M_GCEA	O=C([O-])[C@H](O)CO
M_Glc	OC[C@H]1OC(O)[C@H](O)[C@@H](O)[C@@H]1O
M_Gln	NC(=O)CC[C@H]([NH3+])C(=O)[O-]
M_GLP	O=C1O[C@H](COP(=O)([O-])[O-])[C@@H](O)[C@H](O)[C@H]1O
M_Glu_DASH_SeA	[NH3+][C@@H](CCC=O)C(=O)[O-]
M_Glu	[NH3+][C@@H](CCC(=O)[O-])C(=O)[O-]
M_GluP	[NH3+][C@@H](CCC(=O)OP(=O)([O-])[O-])C(=O)[O-]
M_GLX	O=CC(=O)[O-]
M_Gly	[NH3+]CC(=O)[O-]
M_GMP	Nc1nc2c(ncn2[C@@H]2O[C@H](COP(=O)([O-])[O-])[C@@H](O)[C@H]2O)c(=O)[nH]1
M_GSH	[NH3+][C@@H](CCC(=O)N[C@@H](CS)C(=O)NCC(=O)[O-])C(=O)[O-]
M_GSSG	[NH3+][C@@H](CCC(=O)N[C@@H](CSSC[C@H](NC(=O)CC[C@H]([NH3+])C(=O)[O-])C(=O)NCC(=O)[O-])C(=O)NCC(=O)[O-])C(=O)[O-]
M_GTP	Nc1nc2c(ncn2[C@@H]2O[C@H](COP(=O)([O-])OP(=O)([O-])OP(=O)([O-])O)[C@@H](O)[C@H]2O)c(=O)[nH]1
M_H2O2	OO
M_H2O	O
M_H2S	[SH-]
M_HCO3	O=C([O-])O
M_H_DASH_Cys	[NH3+][C@@H](CCS)C(=O)[O-]
M_H_DASH_Ser	[NH3+][C@@H](CCO)C(=O)[O-]
M_H	[H+]
M_Hisal	[NH3+][C@H](C=O)Cc1c[nH]cn1
M_His	[NH3+][C@@H](Cc1c[nH]cn1)C(=O)[O-]
M_Hisol_DASH_P	[NH3+][C@H](COP(=O)([O-])[O-])Cc1c[nH]cn1
M_Hisol	[NH3+][C@H](CO)Cc1c[nH]cn1
M_HMOB	CC(C)(O)C(=O)C(=O)[O-]
M_HMOP	CCC(C)(O)C(=O)C(=O)[O-]
M_hnu	
M_HPR	O=C([O-])C(=O)CO
M_IA_DASH_P	O=C(COP(=O)([O-])[O-])Cc1c[nH]cn1
M_iCit	O=C([O-])CC(C(=O)[O-])C(O)C(=O)[O-]
M_Ile	CC[C@H](C)[C@H]([NH3+])C(=O)[O-]
M_IMP	O=c1[nH]cnc2c1ncn2[C@@H]1O[C@H](COP(=O)([O-])[O-])[C@@H](O)[C@H]1O
M_Ind_DASH_GP	O=P([O-])([O-])OC[C@@H](O)[C@@H](O)c1c[nH]c2ccccc12
M_Ind	c1ccc2[nH]ccc2c1
M_IPM	CC(C)/C(=C/C(=O)[O-])C(=O)[O-]
M_IPO	CC(C)[C@H](C(=O)[O-])C(=O)C(=O)[O-]
M_KG	O=C([O-])CCC(=O)C(=O)[O-]
M_Leu	CC(C)C[C@H]([NH3+])C(=O)[O-]
M_LPA	NC(=O)CCCC[C@@H]1CCSS1
M_Lys	[NH3+]CCCC[C@H]([NH3+])C(=O)[O-]
M_Mal	O=C([O-])C[C@H](O)C(=O)[O-]
M_Mas	OC[C@H]1O[C@H](O[C@@H]2[C@@H](CO)OC(O)[C@H](O)[C@H]2O)[C@H](O)[C@@H](O)[C@@H]1O
M_mDAP	[NH3+][C@@H](CCC[C@@H]([NH3+])C(=O)[O-])C(=O)[O-]
M_M_DASH_CoA	CC(C)(COP(=O)([O-])OP(=O)([O-])OC[C@H]1O[C@@H](n2cnc3c(N)ncnc32)[C@H](O)[C@@H]1OP(=O)([O-])[O-])[C@@H](O)C(=O)NCCC(=O)NCCSC(=O)CC(=O)[O-]
M_M_DASH_THF	Nc1nc2c(c(=O)[nH]1)N1CN(c3ccc(C(=O)N[C@@H](CCC(=O)[O-])C(=O)[O-])cc3)C[C@H]1CN2
M_Met	CSCC[C@H]([NH3+])C(=O)[O-]
M_MOB	CC(C)C(=O)C(=O)[O-]
M_MOP	CC[C@H](C)C(=O)C(=O)[O-]
M_NADH	NC(=O)C1=CN([C@@H]2O[C@H](COP(=O)([O-])OP(=O)([O-])OC[C@H]3O[C@@H](n4cnc5c(N)ncnc54)[C@H](O)[C@@H]3O)[C@@H](O)[C@H]2O)C=CC1
M_NAD	NC(=O)c1ccc[n+]([C@@H]2O[C@H](COP(=O)([O-])OP(=O)([O-])OC[C@H]3O[C@@H](n4cnc5c(N)ncnc54)[C@H](O)[C@@H]3O)[C@@H](O)[C@H]2O)c1
M_NADPH	NC(=O)C1=CN([C@@H]2O[C@H](COP(=O)([O-])OP(=O)([O-])OC[C@H]3O[C@@H](n4cnc5c(N)ncnc54)[C@H](OP(=O)([O-])[O-])[C@@H]3O)[C@@H](O)[C@H]2O)C=CC1
M_NADP	NC(=O)c1ccc[n+]([C@@H]2O[C@H](COP(=O)([O-])OP(=O)([O-])OC[C@H]3O[C@@H](n4cnc5c(N)ncnc54)[C@H](OP(=O)([O-])[O-])[C@@H]3O)[C@@H](O)[C@H]2O)c1
M_NH4	[NH4+]
M_NO2	O=[N+]=O
M_NO3	O=[N+]([O-])[O-]
M_O2	O=O
M_OAA	O=C([O-])CC(=O)C(=O)[O-]
M_OB	CCC(=O)C(=O)[O-]
M_OMP	O=C([O-])c1cc(=O)[nH]c(=O)n1[C@@H]1O[C@H](COP(=O)([O-])[O-])[C@@H](O)[C@H]1O
M_Orn	[NH3+]CCC[C@H]([NH3+])C(=O)[O-]
M_ORO	O=C([O-])c1cc(=O)[nH]c(=O)[nH]1
M_P5C	O=C([O-])[C@@H]1CCC=N1
M_PCox	
M_PCrd	
M_P_DASH_AICAR_DASH_P	NC(=O)c1ncn([C@@H]2O[C@H](COP(=O)([O-])[O-])[C@@H](O)[C@H]2O)c1/N=C/N[C@@H]1O[C@H](COP(=O)([O-])[O-])[C@@H](O)[C@H]1O
M_P_DASH_HPR	O=C([O-])C(=O)COP(=O)([O-])[O-]
M_PEP	C=C(OP(=O)([O-])[O-])C(=O)[O-]
M_PGA	O=C([O-])[C@H](O)COP(=O)([O-])[O-]
M_PGCA	O=C([O-])COP(=O)([O-])[O-]
M_PH_DASH_Ser	[NH3+][C@@H](CCOP(=O)([O-])[O-])C(=O)[O-]
M_Phe	[NH3+][C@@H](Cc1ccccc1)C(=O)[O-]
M_Pi	O=P([O-])([O-])O
M_PPi	O=P([O-])([O-])OP(=O)([O-])O
M_PQH2	
M_PQ	
M_PRA	[NH3+][C@@H]1O[C@H](COP(=O)([O-])[O-])[C@@H](O)[C@H]1O
M_PR_DASH_AMP	N=c1c2ncn(C3O[C@H](COP(=O)([O-])[O-])[C@@H](O)[C@H]3O)c2ncn1[C@@H]1O[C@H](COP(=O)([O-])[O-])[C@@H](O)[C@H]1O
M_PR_DASH_ANT	O=C([O-])c1ccccc1N[C@@H]1O[C@H](COP(=O)([O-])[O-])[C@@H](O)[C@H]1O
M_PRE	O=C([O-])C(=O)C[C@]1(C(=O)[O-])C=C[C@@H](O)C=C1
M_Pro	O=C([O-])[C@@H]1CCC[NH2+]1
M_PRPP	O=P([O-])([O-])OC[C@H]1O[C@H](OP(=O)([O-])OP(=O)([O-])O)[C@H](O)[C@@H]1O
M_PSer	[NH3+][C@@H](COP(=O)([O-])[O-])C(=O)[O-]
M_Pu_DASH_AICAR_DASH_P	NC(=O)c1ncn([C@@H]2O[C@H](COP(=O)([O-])[O-])[C@@H](O)[C@H]2O)c1N/C=N/CC(=O)[C@H](O)[C@H](O)COP(=O)([O-])[O-]
M_Pyr	CC(=O)C(=O)[O-]
M_QH2	COc1c(O)c(C)c(C/C=C(\C)CC/C=C(\C)CC/C=C(\C)CC/C=C(\C)CC/C=C(\C)CC/C=C(\C)CC/C=C(\C)CCC=C(C)C)c(O)c1OC
M_Q	COC1=C(OC)C(=O)C(C/C=C(\C)CC/C=C(\C)CC/C=C(\C)CC/C=C(\C)CC/C=C(\C)CC/C=C(\C)CC/C=C(\C)CCC=C(C)C)=C(C)C1=O
M_R5P	O=P([O-])([O-])OC[C@H]1OC(O)[C@H](O)[C@@H]1O
M_Rib	OC[C@H]1OC(O)[C@H](O)[C@@H]1O
M_Ru5P	O=C(CO)[C@H](O)[C@H](O)COP(=O)([O-])[O-]
M_RuBP	O=C(COP(=O)([O-])[O-])[C@H](O)[C@H](O)COP(=O)([O-])[O-]
M_S3P	O=C([O-])C1=C[C@@H](OP(=O)([O-])[O-])[C@@H](O)[C@H](O)C1
M_S6P	O=P([O-])([O-])OC[C@H]1O[C@H](O[C@]2(CO)O[C@H](CO)[C@@H](O)[C@@H]2O)[C@H](O)[C@@H](O)[C@@H]1O
M_S7P	O=C(CO)[C@@H](O)[C@H](O)[C@H](O)[C@H](O)COP(=O)([O-])[O-]
M_SAICAR	Nc1c(C(=O)NC(CC(=O)[O-])C(=O)[O-])ncn1[C@@H]1O[C@H](COP(=O)([O-])[O-])[C@@H](O)[C@H]1O
M_SA	O=C([O-])C1=C[C@@H](O)[C@@H](O)[C@H](O)C1
M_SBP	O=C(COP(=O)([O-])[O-])[C@@H](O)[C@H](O)[C@H](O)[C@H](O)COP(=O)([O-])[O-]
M_SCA_DASH_SeA	O=CCCC(=O)[O-]
M_SCA	O=C([O-])CCC(=O)[O-]
M_S_DASH_CoA	CC(C)(COP(=O)([O-])OP(=O)([O-])OC[C@H]1O[C@@H](n2cnc3c(N)ncnc32)[C@H](O)[C@@H]1OP(=O)([O-])[O-])[C@@H](O)C(=O)NCCC(=O)NCCSC(=O)CCC(=O)[O-]
M_S_DASH_DHL	NC(=O)CCCC[C@@H](CCS)SC(=O)CCC(=O)[O-]
M_Ser	[NH3+][C@@H](CO)C(=O)[O-]
M_SO3	O=S([O-])O
M_SO4	O=S(=O)([O-])[O-]
M_starch1	OC[C@H]1OC(O)[C@H](O)[C@@H](O)[C@@H]1O
M_starch2	OC[C@H]1O[C@@H](O[C@@H]2[C@@H](CO)O[C@H](O)[C@H](O)[C@H]2O)[C@H](O)[C@@H](O)[C@@H]1O
M_starch3	OC[C@H]1O[C@@H](O[C@@H]2[C@@H](CO)O[C@@H](O[C@@H]3[C@@H](CO)OC(O)[C@H](O)[C@H]3O)[C@H](O)[C@H]2O)[C@H](O)[C@@H](O)[C@@H]1O
M_starch5	O=C[C@H](O)[C@@H](O)[C@H](O[C@@H]1O[C@H](CO)[C@@H](O[C@@H]2O[C@H](CO)[C@@H](O[C@@H]3O[C@H](CO)[C@@H](O[C@@H]4O[C@H](CO)[C@@H](O)[C@H](O)[C@H]4O)[C@H](O)[C@H]3O)[C@H](O)[C@H]2O)[C@H](O)[C@H]1O)[C@H](O)CO
M_Suc	OC[C@H]1O[C@H](O[C@]2(CO)O[C@H](CO)[C@@H](O)[C@@H]2O)[C@H](O)[C@@H](O)[C@@H]1O
M_T6P	O=P([O-])([O-])OC[C@H]1O[C@H](O[C@H]2O[C@H](CO)[C@@H](O)[C@H](O)[C@H]2O)[C@H](O)[C@@H](O)[C@@H]1O
M_THD	O=C([O-])C1=N[C@H](C(=O)[O-])CCC1
M_THF	Nc1nc2c(c(=O)[nH]1)N[C@@H](CNc1ccc(C(=O)N[C@@H](CCC(=O)[O-])C(=O)[O-])cc1)CN2
M_Thr	C[C@@H](O)[C@H]([NH3+])C(=O)[O-]
M_Tre	OC[C@H]1O[C@H](O[C@H]2O[C@H](CO)[C@@H](O)[C@H](O)[C@H]2O)[C@H](O)[C@@H](O)[C@@H]1O
M_Trp	[NH3+][C@@H](Cc1c[nH]c2ccccc12)C(=O)[O-]
M_Tyr	[NH3+][C@@H](Cc1ccc(O)cc1)C(=O)[O-]
M_UDPG	O=c1ccn([C@@H]2O[C@H](COP(=O)([O-])OP(=O)([O-])O[C@H]3O[C@H](CO)[C@@H](O)[C@H](O)[C@H]3O)[C@@H](O)[C@H]2O)c(=O)[nH]1
M_UDP	O=c1ccn([C@@H]2O[C@H](COP(=O)([O-])OP(=O)([O-])O)[C@@H](O)[C@H]2O)c(=O)[nH]1
M_UMP	O=c1ccn([C@@H]2O[C@H](COP(=O)([O-])[O-])[C@@H](O)[C@H]2O)c(=O)[nH]1
M_Val	CC(C)[C@H]([NH3+])C(=O)[O-]
M_X5P	O=C(CO)[C@@H](O)[C@H](O)COP(=O)([O-])[O-]
M_XMP	O=c1[nH]c(=O)c2ncn([C@@H]3O[C@H](COP(=O)([O-])[O-])[C@@H](O)[C@H]3O)c2[nH]1
M_ACP	SCCNC(=O)CCNC(=O)[C@H](O)C(C)(C)COP([O-])(=O)O[C]
M_AD	Nc1ncnc2[nH]cnc12
M_AICAR	NC(=O)c1ncn([C@@H]2O[C@H](COP(=O)([O-])[O-])[C@@H](O)[C@H]2O)c1N
M_AIR	Nc1c[nH+]cn1[C@@H]1O[C@H](COP(=O)([O-])[O-])[C@@H](O)[C@H]1O
M_amDHP	CNC(=O)CCCCC(S)CCSC[NH3+]
M_aMet	C[S+](CC[C@H]([NH3+])C(=O)[O-])C[C@H]1O[C@@H](n2cnc3c(N)ncnc32)[C@H](O)[C@@H]1O
M_ATP	Nc1ncnc2c1ncn2[C@@H]1O[C@H](COP(=O)([O-])OP(=O)([O-])OP(=O)([O-])O)[C@@H](O)[C@H]1O
M_CBP	NC(=O)OP(=O)([O-])[O-]
M_CTP	Nc1ccn([C@@H]2O[C@H](COP(=O)([O-])OP(=O)([O-])OP(=O)([O-])O)[C@@H](O)[C@H]2O)c(=O)n1
M_Cytcox	*NC(=O)[C@H](CSC(C)C1=C(C)C2=N/C1=C\c1c(C)c(CCC(=O)[O-])c3n1[Fe+]n1/c(c(C)c(C(C)SC[C@H](NC(*)=O)C(=O)N*)/c1=C/2)=C\C1=N/C(=C\3)C(CCC(=O)[O-])=C1C)NC(*)=O
M_Cytcrd	*NC(=O)[C@H](CSC(C)C1=C(C)C2=N/C1=C\c1c(C)c(CCC(=O)[O-])c3n1[Fe]n1/c(c(C)c(C(C)SC[C@H](NC(*)=O)C(=O)N*)/c1=C/2)=C\C1=N/C(=C\3)C(CCC(=O)[O-])=C1C)NC(*)=O
M_dGDP	Nc1nc2c(ncn2[C@H]2C[C@H](O)[C@@H](COP(=O)([O-])OP(=O)([O-])O)O2)c(=O)[nH]1
M_dGTP	Nc1nc2c(ncn2[C@H]2C[C@H](O)[C@@H](COP(=O)([O-])OP(=O)([O-])OP(=O)([O-])O)O2)c(=O)[nH]1
M_DHF	Nc1nc2c(c(=O)[nH]1)N=C(CNc1ccc(C(=O)N[C@@H](CCC(=O)[O-])C(=O)[O-])cc1)CN2
M_DHP	CNC(=O)CCCCC(S)CCS
M_Fdox	
M_Fdrd	
M_FGAM	[NH2+]=C(CNC=O)N[C@@H]1O[C@H](COP(=O)([O-])[O-])[C@@H](O)[C@H]1O
M_GDP	Nc1nc2c(ncn2[C@@H]2O[C@H](COP(=O)([O-])OP(=O)([O-])O)[C@@H](O)[C@H]2O)c(=O)[nH]1
M_LPL	CNC(=O)CCCCC1CCSS1
M_ThPP	Cc1ncc(C[n+]2csc(CCOP(=O)([O-])OP(=O)([O-])O)c2C)c(N)n1
M_TRXox	*[NH2+][C@H]1CSSC[C@@H](C(*)=O)NC(=O)[C@H](*)NC(=O)[C@H](*)NC1=O
M_TRXrd	*[NH2+][C@@H](CS)C(=O)N[C@@H](*)C(=O)N[C@@H](*)C(=O)N[C@@H](CS)C(*)=O
M_urea	NC(N)=O
M_UTP	O=c1ccn([C@@H]2O[C@H](COP(=O)([O-])OP(=O)([O-])OP(=O)([O-])O)[C@@H](O)[C@H]2O)c(=O)[nH]1
M_5M_DASH_THF	CN1c2c(nc(N)[nH]c2=O)NC[C@@H]1CNc1ccc(C(=O)N[C@@H](CCC(=O)[O-])C(=O)[O-])cc1
M_A_DASH_Glu	CC(=O)N[C@@H](CCC(=O)[O-])C(=O)[O-]
M_A_DASH_GluP	CC(=O)N[C@@H](CCC(=O)OP(=O)([O-])[O-])C(=O)[O-]
M_A_DASH_Orn	CC(=O)N[C@@H](CCC[NH3+])C(=O)[O-]
M_F_DASH_THF	Nc1nc2c(c(=O)[nH]1)N[C@@H](CN(C=O)c1ccc(C(=O)N[C@@H](CCC(=O)[O-])C(=O)[O-])cc1)CN2
M_H_DASH_Eth_DASH_ThPP	Cc1ncc(C[n+]2c(C(C)O)sc(CCOP(=O)([O-])OP(=O)([O-])O)c2C)c(N)n1
M_M_DASH_ACP	OC(=O)CC(=O)SCCNC(=O)CCNC(=O)[C@H](O)C(C)(C)COP([O-])(=O)O[C]
M_PR_DASH_ATP	N=c1c2ncn(C3O[C@H](COP(=O)([O-])OP(=O)([O-])OP(=O)([O-])O)[C@@H](O)[C@H]3O)c2ncn1[C@@H]1O[C@H](COP(=O)([O-])[O-])[C@@H](O)[C@H]1O
