M_2IPM	BITYXLXUCSKTJS-ZETCQYMHSA-L
M_2PGA	GXIURPTVHJPJLF-UWTATZPHSA-K
M_3IPM	RNQHMTFBUSSBJQ-CRCLSJGQSA-L
M_4MOP	BKAJNAXTPSGJCU-UHFFFAOYSA-M
M_6PG	BIRSGZKFKXLSJQ-SQOUGZDYSA-K
M_AC	QTBSBXVTEAMEQO-UHFFFAOYSA-M
M_ACD	IKHGUXGNUITLKF-UHFFFAOYSA-N
M_A_DASH_CoA	ZSLZBFCDCINBPY-ZSJPKINUSA-J
M_A_DASH_DHL	ARGXEXVCHMNAQU-UHFFFAOYSA-N
M_A_DASH_Glu_DASH_SeA	BCPSFKBPHHBDAI-LURJTMIESA-M
M_A_DASH_Ser	VZXPDPZARILFQX-BYPYZUCNSA-N
M_ADN	OIRDTQYFTABQOQ-KQYNXXCUSA-N
M_ADP	XTWYTFMLZFPYCI-KQYNXXCUSA-L
M_ADPG	WFPZSXYXPSUOPY-ROYWQJLOSA-L
M_AGN	MIEILDYWGANZNH-DSQUFTABSA-M
M_AHB	VUQLHQFKACOHNZ-LURJTMIESA-M
M_aH_DASH_Cys	ZJUKTBDSGOFHSH-WFMPWKQPSA-N
M_AL	NMDWGEGFJUBKLB-UHFFFAOYSA-M
M_Ala	QNAYBMKLOCPYGJ-REOHCLBHSA-N
M_AMP	UDMBCSSLTHHNCD-KQYNXXCUSA-L
M_ANT	RWZYAGGXGHYGMB-UHFFFAOYSA-M
M_APS	IRLPACMLTUPBCL-KQYNXXCUSA-L
M_Arg	ODKSFYDXXFIFQN-BYPYZUCNSA-O
M_Arg_DASH_SCA	KDZOASGQNOPSCU-ZBHICJROSA-M
M_Asn	DCXYFEDJOCDNAF-REOHCLBHSA-N
M_Asp	CKLJMWTZIZZHCS-UWTATZPHSA-M
M_Asp_DASH_SeA	HOSWPDPVFBCLSY-VKHMYHEASA-N
M_AspP	IXZNKTPIYKDIGG-REOHCLBHSA-L
M_cACN	GTZCVFVGUGFEME-IWQZZHSRSA-K
M_CAIR	XFVULMDJZXYMSG-ZIYNGMLESA-L
M_CB_DASH_Asp	HLKXYZVTANABHZ-REOHCLBHSA-L
M_CDP	ZWIADYZPOWUWEW-XVFCMESISA-L
M_cellulose1	WQZGKKKJIJFFOK-VFUOTHLCSA-N
M_cellulose2	GUBGYTABKSRVRQ-QRZGKKJRSA-N
M_cellulose3	FYGDTMLNYKFZSV-ZWSAEMDYSA-N
M_CHR	WTFXTQVDAKGDEY-HTQZYQBOSA-L
M_Cit	KRKNYBCHXYNGOX-UHFFFAOYSA-K
M_CO2	CURLTUGMZLYLDI-UHFFFAOYSA-N
M_CoA	RGJOEKWQDUBAIZ-IBOSZNHHSA-J
M_CPD_DASH_Ru5P	QKMBYNRMPRKVTO-MNOVXSKESA-K
M_CTH	ILRYLPWNYFXEMH-RFZPGFLSSA-N
M_CTL	RHGKLRLOHDJJDR-BYPYZUCNSA-N
M_Cys	XUJNEKJLAYXESH-REOHCLBHSA-N
M_dADP	DAEAPNUQQAICNR-RRKCRQDMSA-L
M_DAHP	PJWIPEXIFFQAQZ-PUFIMZNGSA-K
M_DAP	GMKMEZVLHJARHF-WHFBIAKZSA-N
M_dATP	SUYVUBYJARFZHO-RRKCRQDMSA-K
M_DC_DASH_AMP	OFBHPPMPBOJXRT-DPXQIYNJSA-J
M_dCDP	FTDHDKPUHBLBTL-SHYZEUOFSA-L
M_dCTP	RGWHQCVHVJXOKC-SHYZEUOFSA-K
M_DHAP	GNGACRATGGDKBX-UHFFFAOYSA-L
M_DHD	UWOCFOFVIBZJGH-YFKPBYRVSA-L
M_DHL	VLYUGYAKYZETRF-SSDOTTSWSA-N
M_DHMB	JTEYKUFKXGDTEU-VKHMYHEASA-M
M_DHMP	PDGXJDXVGMHUIR-UJURSFKZSA-M
M_DHO	UFIVEPVSAGBUSI-REOHCLBHSA-M
M_DHQ	WVMWZWGZRAXUBK-SYTVJDICSA-M
M_DHS	SLWWJZMPHJJOPH-PHDIDXHHSA-M
M_DPGA	LJQLQCAXBUHEAZ-UWTATZPHSA-J
M_dTDP	UJLXYODCHAELLY-XLPZGREQSA-L
M_dTMP	GYOZYWVXFNDGLU-XLPZGREQSA-L
M_dTTP	NHVNXKFIZYSCEB-XLPZGREQSA-K
M_dUDP	QHWZTVCCBMIIKE-SHYZEUOFSA-L
M_dUMP	JSRLJPSBLDHEIO-SHYZEUOFSA-L
M_dUTP	AHCYMLUZIRLXAA-SHYZEUOFSA-K
M_E4P	NGHMDNPXVRFFGS-IUYQGCFVSA-L
M_EIGP	HFYBTHCYPKEDQQ-RITPCOANSA-L
M_EPSP	QUTYKIXIUDQOLK-PRJMDXOYSA-J
M_F26BP	YXWOAJXNVLXPMU-ZXXMMSQZSA-J
M_F6P	BGWGXPAPYGQALX-VRPWFDPXSA-L
M_FAICAR	ABCOOORLYAOBOZ-KQYNXXCUSA-L
M_FBP	RNBGYGVWRKECFJ-VRPWFDPXSA-J
M_FGAR	VDXLUNDMVKSKHO-XVFCMESISA-L
M_For	BDAGIHXWWSANSR-UHFFFAOYSA-M
M_Frc	RFSUNEUAIZKAJO-VRPWFDPXSA-N
M_Fum	VZCYOOQTPOCHFL-OWOJBTEDSA-L
M_G1P	HXXFSFRBOHSIMQ-VFUOTHLCSA-L
M_G6P	NBSCHQHZLSJFNQ-GASJEMHNSA-L
M_GABA	BTCSSZJGUNDROE-UHFFFAOYSA-N
M_GAP	LXJXRIRHZLFYRP-VKHMYHEASA-L
M_GAR	OBQMLSFOUZUIOB-SHUUEZRQSA-M
M_GCA	AEMRFAOFKBGASW-UHFFFAOYSA-M
M_GCEA	RBNPOMFGQQGHHO-UWTATZPHSA-M
M_Glc	WQZGKKKJIJFFOK-GASJEMHNSA-N
M_Gln	ZDXPYRJPNDTMRX-VKHMYHEASA-N
M_GLP	IJOJIVNDFQSGAB-SQOUGZDYSA-L
M_Glu_DASH_SeA	KABXUUFDPUOJMW-BYPYZUCNSA-N
M_Glu	WHUUTDBJXJRKMK-VKHMYHEASA-M
M_GluP	PJRXVIJAERNUIP-VKHMYHEASA-L
M_GLX	HHLFWLYXYJOTON-UHFFFAOYSA-M
M_Gly	DHMQDGOQFOQNFH-UHFFFAOYSA-N
M_GMP	RQFCJASXJCIDSX-UUOKFMHZSA-L
M_GSH	RWSXRVCMGQZWBV-WDSKDSINSA-M
M_GSSG	YPZRWBKMTBYPTK-BJDJZHNGSA-L
M_GTP	XKMLYUALXHKNFT-UUOKFMHZSA-K
M_H2O2	MHAJPDPJQMAIIY-UHFFFAOYSA-N
M_H2O	XLYOFNOQVPJJNP-UHFFFAOYSA-N
M_H2S	RWSOTUBLDIXVET-UHFFFAOYSA-M
M_HCO3	BVKZGUZCCUSVTD-UHFFFAOYSA-M
M_H_DASH_Cys	FFFHZYDWPBMWHY-VKHMYHEASA-N
M_H_DASH_Ser	UKAUYVFTDYCKQA-VKHMYHEASA-N
M_H	GPRLSGONYQIRFK-UHFFFAOYSA-N
M_Hisal	VYOIELONWKIZJS-YFKPBYRVSA-O
M_His	HNDVDQJCIGZPNO-YFKPBYRVSA-N
M_Hisol_DASH_P	CWNDERHTHMWBSI-YFKPBYRVSA-M
M_Hisol	ZQISRDCJNBUVMM-YFKPBYRVSA-O
M_HMOB	DNOPJXBPONYBLB-UHFFFAOYSA-M
M_HMOP	YJVOWRAWFXRESP-UHFFFAOYSA-M
M_HPR	HHDDCCUIIUWNGJ-UHFFFAOYSA-M
M_IA_DASH_P	YCFFMSOLUMRAMD-UHFFFAOYSA-L
M_iCit	ODBLHEXUDAPZAU-UHFFFAOYSA-K
M_Ile	AGPKZVBTJJNPAG-WHFBIAKZSA-N
M_IMP	GRSZFWQUAKGDAV-KQYNXXCUSA-L
M_Ind_DASH_GP	NQEQTYPJSIEPHW-MNOVXSKESA-L
M_Ind	SIKJAQJRHWYJAI-UHFFFAOYSA-N
M_IPM	NJMGRJLQRLFQQX-HYXAFXHYSA-L
M_IPO	HIIZAGQWABAMRR-BYPYZUCNSA-L
M_KG	KPGXRSRHYNQIFN-UHFFFAOYSA-L
M_Leu	ROHFNLRQFUQHCH-YFKPBYRVSA-N
M_LPA	FCCDDURTIIUXBY-SSDOTTSWSA-N
M_Lys	KDXKERNSBIXSRK-YFKPBYRVSA-O
M_Mal	BJEPYKJPYRNKOW-REOHCLBHSA-L
M_Mas	GUBGYTABKSRVRQ-PICCSMPSSA-N
M_mDAP	GMKMEZVLHJARHF-SYDPRGILSA-N
M_M_DASH_CoA	LTYOQGRJFJAKNA-DVVLENMVSA-I
M_M_DASH_THF	QYNUQALWYRSVHF-OLZOCXBDSA-L
M_Met	FFEARJCKVFRZRR-BYPYZUCNSA-N
M_MOB	QHKABHOOEWYVLI-UHFFFAOYSA-M
M_MOP	JVQYSWDUAOAHFM-BYPYZUCNSA-M
M_NADH	BOPGDPNILDQYTO-NNYOXOHSSA-L
M_NAD	BAWFJGJZGIEFAR-NNYOXOHSSA-M
M_NADPH	ACFIXJIJDZMPPO-NNYOXOHSSA-J
M_NADP	XJLXINKUBYWONI-NNYOXOHSSA-K
M_NH4	QGZKDVFQNNGYKY-UHFFFAOYSA-O
M_NO2	OMBRFUXPXNIUCZ-UHFFFAOYSA-N
M_NO3	NHNBFGGVMKEFGY-UHFFFAOYSA-N
M_O2	MYMOFIZGZYHOMD-UHFFFAOYSA-N
M_OAA	KHPXUQMNIQBQEV-UHFFFAOYSA-L
M_OB	TYEYBOSBBBHJIV-UHFFFAOYSA-M
M_OMP	KYOBSHFOBAOFBF-XVFCMESISA-K
M_Orn	AHLPHDHHMVZTML-BYPYZUCNSA-O
M_ORO	PXQPEWDEAKTCGB-UHFFFAOYSA-M
M_P5C	DWAKNKKXGALPNW-BYPYZUCNSA-M
M_P_DASH_AICAR_DASH_P	QOUSHGMTBIIAHR-KEOHHSTQSA-J
M_P_DASH_HPR	LFLUCDOSQPJJBE-UHFFFAOYSA-K
M_PEP	DTBNBXWJWCWCIK-UHFFFAOYSA-K
M_PGA	OSJPPGNTCRNQQC-UWTATZPHSA-K
M_PGCA	ASCFNMCAHFUBCO-UHFFFAOYSA-K
M_PH_DASH_Ser	FXDNYOANAXWZHG-VKHMYHEASA-L
M_Phe	COLNVLDHVKWLRT-QMMMGPOBSA-N
M_Pi	NBIIXXVUZAFLBC-UHFFFAOYSA-L
M_PPi	XPPKVPWEQAFLFU-UHFFFAOYSA-K
M_PRA	SKCBPEVYGOQGJN-TXICZTDVSA-M
M_PR_DASH_AMP	RTQMRTSPTLIIHM-TYASJMOZSA-J
M_PR_DASH_ANT	PMFMJXPRNJUYMB-GWOFURMSSA-K
M_PRE	FPWMCUPFBRFMLH-XGAOUMNUSA-L
M_Pro	ONIBWKKTOPOVIA-BYPYZUCNSA-N
M_PRPP	PQGCEDQWHSBAJP-TXICZTDVSA-J
M_PSer	BZQFBWGGLXLEPQ-REOHCLBHSA-L
M_Pu_DASH_AICAR_DASH_P	BLKFNHOCHNCLII-GHVQHMAVSA-J
M_Pyr	LCTONWCANYUPML-UHFFFAOYSA-M
M_QH2	LOJUQFSPYHMHEO-SGHXUWJISA-N
M_Q	ICFIZJQGJAJRSU-SGHXUWJISA-N
M_R5P	KTVPXOYAKDPRHY-SOOFDHNKSA-L
M_Rib	HMFHBZSHGGEWLO-SOOFDHNKSA-N
M_Ru5P	FNZLKVNUWIIPSJ-UHNVWZDZSA-L
M_RuBP	YAHZABJORDUQGO-NQXXGFSBSA-J
M_S3P	QYOJSKGCWNAKGW-PBXRRBTRSA-K
M_S6P	WQQSIXKPRAUZJL-UGDNZRGBSA-L
M_S7P	JDTUMPKOJBQPKX-GBNDHIKLSA-L
M_SAICAR	NAQGHJTUZRHGAC-LBGUGVGYSA-J
M_SA	JXOHGGNKMLTUBP-HSUXUTPPSA-M
M_SBP	OKHXOUGRECCASI-SHUUEZRQSA-J
M_SCA_DASH_SeA	UIUJIQZEACWQSV-UHFFFAOYSA-M
M_SCA	KDYFGRWQOYBRFD-UHFFFAOYSA-L
M_S_DASH_CoA	VNOYUJKHFWYWIR-ITIYDSSPSA-I
M_S_DASH_DHL	RJCJWONCSKSHES-VIFPVBQESA-M
M_Ser	MTCFGRXMJLQNBG-REOHCLBHSA-N
M_SO3	LSNNMFCWUKXFEE-UHFFFAOYSA-M
M_SO4	QAOWNCQODCNURD-UHFFFAOYSA-L
M_starch1	WQZGKKKJIJFFOK-GASJEMHNSA-N
M_starch2	GUBGYTABKSRVRQ-MFRLZQSSSA-N
M_starch3	FYGDTMLNYKFZSV-ZWSAEMDYSA-N
M_starch5	FJCUPROCOFFUSR-YIQJLYQHSA-N
M_Suc	CZMRCDWAGMRECN-UGDNZRGBSA-N
M_T6P	LABSPYBHMPDTEL-LIZSDCNHSA-L
M_THD	CXMBCXQHOXUCEO-BYPYZUCNSA-L
M_THF	MSTNYGQPCMXVAQ-RYUDHWBXSA-L
M_Thr	AYFVYJQAPQTCCC-GBXIJSLDSA-N
M_Tre	HDTRYLNUVZCQOY-LIZSDCNHSA-N
M_Trp	QIVBCDIJIAJPQS-VIFPVBQESA-N
M_Tyr	OUYCCCASQSFEME-QMMMGPOBSA-N
M_UDPG	HSCJRCZFDFQWRP-JZMIEXBBSA-L
M_UDP	XCCTYIAWTASOJW-XVFCMESISA-L
M_UMP	DJJCXFVJDGTHFX-XVFCMESISA-L
M_Val	KZSNJWFQEVHDMF-BYPYZUCNSA-N
M_X5P	FNZLKVNUWIIPSJ-RFZPGFLSSA-L
M_XMP	DCTLYFZHFGENCW-UUOKFMHZSA-L
M_ACP	YUNAMKPUENQFOX-JTQLQIEISA-M
M_AD	GFFGJBXGBJISGV-UHFFFAOYSA-N
M_AICAR	NOTGFIUVDGNKRI-UUOKFMHZSA-L
M_AIR	PDACUKOKVHBVHJ-XVFCMESISA-M
M_amDHP	JZHRQTGPGYZYAO-UHFFFAOYSA-O
M_aMet	MEFKEPWMEQBLKI-AIRLBKTGSA-O
M_ATP	ZKHQWZAMYRWXGA-KQYNXXCUSA-K
M_CBP	FFQKYPRQEYGKAF-UHFFFAOYSA-L
M_CTP	PCDQPRRSZKQHHS-XVFCMESISA-K
M_dGDP	CIKGWCTVFSRMJU-KVQBGUIXSA-L
M_dGTP	HAAZLUGHYHWQIW-KVQBGUIXSA-K
M_DHF	OZRNSSUDZOLUSN-LBPRGKRZSA-L
M_DHP	XPQZROWEXKEMGP-UHFFFAOYSA-N
M_FGAM	PMCOGCVKOAOZQM-XVFCMESISA-M
M_GDP	QGWNDRXFNXRZMB-UUOKFMHZSA-L
M_LPL	FUMZEQODHXNVQE-UHFFFAOYSA-N
M_ThPP	AYEKOFBPNLCAJY-UHFFFAOYSA-M
M_urea	XSQUKJJJFZCRTK-UHFFFAOYSA-N
M_UTP	PGAVKCOVUIYSFO-XVFCMESISA-K
M_5M_DASH_THF	ZNOVTXRBGFNYRX-STQMWFEESA-L
M_A_DASH_Glu	RFMMMVDNIPUKGG-YFKPBYRVSA-L
M_A_DASH_GluP	FCVIHFVSXHOPSW-YFKPBYRVSA-K
M_A_DASH_Orn	JRLGPAXAGHMNOL-LURJTMIESA-N
M_F_DASH_THF	AUFGTPPARQZWDO-YPMHNXCESA-L
M_H_DASH_Eth_DASH_ThPP	RRUVJGASJONMDY-UHFFFAOYSA-M
M_M_DASH_ACP	LDWMIVAQJLWQGZ-ZDUSSCGKSA-M
M_PR_DASH_ATP	RKNHJBVBFHDXGR-TYASJMOZSA-I
